111111111
100010001
101C1C101
1P10001E1
111111111